 R 1920 1080
NO ./textures/redbrick.xpm
SO ./textures/greystone.xpm
EA ./textures/bluestone.xpm
WE ./textures/purplestone.xpm

S ./textures/barrel.xpm
F 180,180,180
C 96,200,240

1111111111111111
1000010001000021
1000000000000201
100E001110000001
1000000100000021
1000000100000021
1000000000000021
1000100010010021
1111111111111111
