R 1920 1080
NO ./resources/Texture-nord-256.xpm
SO ./resources/Texture-sud-256.xpm
EA ./resources/Texture-est-256.xpm
WE ./resources/Texture-ouest-256.xpm

S yz
F 160,82,45
C 96,210,240


 111111111111111111111111111111111
10000000000000000000000000000000001
10000000000000000000000000000000001
10000000000S0000000111111111111111
1000000000000000001
1000000000000000001
 11111111111111111