R 1500	1000
NO ./resources/Texture-nord-256.xpm
SO ./resources/Texture-sud-256.xpm
EA ./resources/Texture-est-256.xpm
WE ./resources/Texture-ouest-256.xpm

S	./resources/sprite_1.xpm
F	180,180,180
C	96,200,240


1111111111111111
1E00000000000021
10000000000000201
1000000000000021
1000000000000021
1000000000000021
1111111111111111