R 1500	1000
NO ./resources/Texture-nord-256.xpm
SO ./resources/Texture-sud-256.xpm
EA ./resources/Texture-est-256.xpm
WE ./resources/Texture-ouest-256.xpm

S	./resources/sprite_1.xpm
F	180,180,180
C	96,200,240

1111111111111111111111111111111111111111111111111111111111111
1S11111111111111111111111111111111111111111111111111111111111
1000000000001000001000000000000000000000000000100000000000001
1110101110111010101110101011111110111010111110101111111111101
1010100010001010100000101010000010100010000010001000001000101
1010101011101010111111101010111010101111101011111011111010101
1000101000100010001010001010100010100000101000000010001010001
1010101110111111101010101011101111111110101011111110101011111
1010100010000010101010101000101000000000101010000000100010001
1011111010111010101010101110101111111011101110111111111110101
1000001010100010001010100010001000001000100010000000000000101
1011101011101111101010111110111011101110111010111111111011101
1000101000100000101010000010101000101010100010100000001000101
1110101110111110111011111010101111101010101111101111101110101
1010101000100010001000100010001000001000101000101000001000101
1010101011101011101110101111111010111111101010111010111011101
1010101000101000100010001000000010000010101010001010001010101
1010101110101110101011111011101110111010101010101010101010101
1000100010001000101000001000100010001000101010100010101010101
1011111011111011111111101110101011101111101011111111101010101
1000001010100010000000100010101000101000100010001000101000101
1011101010101110111110111010111110101010111110101110101011101
1010001010100010100010001010100000101010000000100000101000101
1010111010101011101011101010101111101011111011111111101110101
1010001000101000001000101000100000101010001000000000101000101
1011101111111010111110101111111110101010101111111110101111101
1000100010001010000010001000001000100010100000000010100000101
1011111010101011111111111010101011111110101111111011111110101
1010001000101000001000100010101000000000101000001000100010101
1010101111101011101010101010101111111111111010101110101010101
1010100000001000101010001010100000000000000010101000101010101
1110111111111110101011111010111111111110111110101011101010101
1000100000100010101010001010000000000010001000101000001010101
1010111110101110101010101010111111111010101011101111111110101
1010100000100010101010100010000000100010101010100000001000101
1011101011111010101010111111111111101110101010111111101011101
1000101010001000100010001000000010001000101000100010001010101
1010101011101011111111111011111010101011101011111010111010101
1010101000101010000000100010000010101010001010001010001010101
1010101110101011111110101110111110101010111110101010101010101
1010001010101000100000100010001000101010000000101010101010101
1011111010101010101111111011111011101011111111101010101010101
1000000010101010001000101000100010001000001000100010101000101
1011111010101011111010101010101110111011101010111111101111101
1000001010001000000010001010001010001010001010000000101000101
1011101111111111111111111010111010101010111011111110101010101
1000101000000000001000000010100010101010000010000010101010101
1110101010111111101110111111101010101111111110101010101011101
1010100010000010100010000010001010100000000000101010101000001
1010101111101010111011111110101010101111111111111010101111111
1010100000101000101000000000101010101000000000100010100000001
1010101110101111101111111111111010111011111110101110111111101
1000101000100000001000000000100010000010001000100010000000101
1011101011111011111011111110101111111110101111101010111111101
1000101000001000100010001000101000000010100000101010101000001
1110101111101110101010101010101010111010111110111010101011111
1010100000100010101010101010100010001010100000100010001010001
1010111111111010101110101011111111111010101011101111111010101
1010100000100010101000101000000000000010101000101000000010101
1010101110111111101011101111111111111110101111101011111111101
1000100010000000001000100000000000000000100000001000000000021
1111111111111111111111111111111111111111111111111111111111111
