R 1500	1000
NO ./resources/Texture-nord-256.xpm
SO ./resources/Texture-sud-256.xpm
EA ./resources/Texture-est-256.xpm
WE ./resources/Texture-ouest-256.xpm

S	./resources/sprite_1.xpm
F	180,180,180
C	96,200,240

11111111111111111111111111111111111111111111111111111111
1E000000000000000000000000000000000000000000000000000001
10000000000000000000000000000000000000000000000002000001
10000000000000000000000000000000000000000000000002000001
10000000000000000000020000000200000000000000000002000001
10000000000000000000020000000200000000000000000000000001
10000000000000000000020000000200000000000000000000000001
10000000000000000000020000000200000000000000000000000001
10000000000000000000000000000000000000000000000000000001
10000000000000000000000000000000000000000000000000000001
11111111111111111111111111111111111111111111111111111111
