R	1920	1080
NO ./textures/redbrick.xpm
SO ./textures/redbrick.xpm
EA ./textures/redbrick.xpm
WE ./textures/redbrick.xpm
S ./textures/barrel.xpm

F 255,0,255
C 0,128,128


11111
10S01
10201
10201
10201
10201
10201
10201
10201
10201
10201
10201
10201
10201
10201
10201
10201
10201
10201
10201
10201
10201
10201
10201
10201
10201
10201
10201
10201
10201
10201
10201
10201
10201
10201
10201
10201
10201
10201
10201
10201
10201
10201
10201
10201
10201
10201
10201
10201
10201
10201
10201
10201
10201
10201
10201
10201
10201
10201
10201
10201
10201
10201
10201
10201
10201
10201
11111
