R	1920	1080
NO ./textures/bluestone.xpm
SO ./textures/greystone.xpm
WE ./textures/purplestone.xpm
WE ./textures/purplestone.xpm
EA ./textures/redbrick.xpm
S ./textures/barrel.xpm

F 24,85,2
C 29,25,01

11111111111111111111111111111111
10000    00000000000000000000001
1E0000200000200    0000200011111
1000000000000000000000000001
1000000000000000020000000001
1111111111111111111111111111
